W	W	W	W	W	W	W	W	W	W	W	W	W	W	W
W	A	F	F	W	F	F	F	F	F	F	F	F	A	W
W	F	W	F	W	W	W	W	W	W	W	W	W	F	W
W	F	W	F	W	F	F	F	F	F	F	F	W	F	W
W	F	W	F	W	F	W	W	W	W	W	F	W	F	W
W	F	W	F	W	F	W	F	F	F	W	F	W	F	W
W	F	W	F	W	F	W	F	W	F	W	F	W	F	W
W	F	W	F	F	F	W	P	W	F	W	F	W	F	W
W	F	W	F	W	F	W	W	W	F	W	F	W	F	W
W	F	W	F	W	F	F	F	F	F	W	F	W	F	W
W	F	W	F	W	F	F	A	F	F	W	F	W	F	W
W	F	W	F	W	W	W	W	W	W	W	F	W	F	W
W	F	W	F	F	F	F	F	F	F	W	F	W	F	W
W	A	F	F	W	W	W	W	W	A	W	F	F	A	W
W	W	W	W	W	W	W	W	W	W	W	W	W	W	W
