W	W	W	W	W	W	W
W	A	F	F	F	A	W
W	F	F	F	F	F	W
W	F	F	P	F	F	W
W	F	F	F	F	F	W
W	A	F	F	F	A	W
W	W	W	W	W	W	W